31111111111111114
72222222222222228
7.P.............8
7...............8
7.....E.........8
7...............8
7...............8
7.........E.....8
7.........E.....8
7..............H8
7...............8
7...............8
7...............8
7...............8
7...............8
9MMMMMMMMMMMMMMM0
