3111111111111111111114
5222222222222222222226
7....................8
7....................8
7P...................8
7....................8
7....................8
7....................8
9MMMMMMMMMMMMMMMMMMMM0